0303030303030303030303030303030303030303030303030303030303030303020202020202020202020201565601010202020202020202020202020202020202020202020202020202020202020202020202020202020202020202020202020202020201010101010101010202020202020202020202020202020202020202
03030303030303030303030303030303030303030303030303030303030303030202020202020202020202013f01440e0202020202020202020202020202020202020202020202020202020202020202020202020202020202020202020202020202020202565656565656020202020202020202020202020202020202020202
0303030303030303030303030303030303030303101111111111120303030303020202020202020202020201565601010202020202020202020202020202020202020202020202020202020202020202020202020202020202020202020202020202020202560101010156020202020202020202020202020202020202020202
0303030303031011120303030303030303030303200202020202220303030303020202020202020202020202025656560202020202020202020202020202020202020202020202020202020202020202020202020202020202020202020202020202020202560e44080156020202020202020202020202020202020202020202
030303101111240e231111120303030303030303200202020202220303030303020202020202020202020202020202020202020202020201010102020202020202020202020202020202020202020202020202020202020202020202020202020202020202565656563f56020202020202020202020202020202020202020202
030303200404040104050422030303030303030320040404040422030303030302020202020202020202020202020202020202020202565656565602020202025656565602020202020202020202020202020202020202020202020201565656020202020201010101b501020202020202020202020202020202020202020202
030303204a01080808014b22030303030303030320404d4e4f432203030303030202020202020202020202020202020202020202020256010e01560202020202010e0156020202020202020202020202020202020202020202020202015601010202020202020202020202020202020202020202020202020202020202020202
030303204001080808014222030303030303030320015d5e5f01220303030303020202020202020202020202020202020202020202025608440856020202020208440856020202020202020202020202020202020202020202020202013f080e0202020202020202020202020202020202020202020202020202020202020202
030303200c01080808010122030303030303030320416d6e6f422203030303030202020202020202020202020202020202020202020256b5b5b5560202020202b5b5b556020202020202020202020202020202020202020202020202015608440202020202020202020202020202020202020202020202020202020202020202
03030320010101010101012203030303030303032001010101012203030303030202020202020202020202020202020202020202020256563f56560202020202563f5656020202020202020202020202020202020202020202020202015601010202020202020202020202020202020202020202020202020202020202020202
030303204a01010101010d2203030303030303033014b5b5b513320303030303020202020202020202020202020202020202020202020101b50101020202020201b50101020202020202020202020202020202020202020202020202015656560202020202020202020202020202020202020202020202020202020202020202
03030330313114b51331313203030303030303030320010f0122030303030303020202020202020202020202020202020202020202020202020202020202020202020202020202020202020202020202020202020202020202020202020202020202020202020202020202020202020202020202020201010101020202020202
03030303030320b6220303030303030303030303033031313132030303030303020202020202020202020202020202020202020202020202020202020202020202020202020202020202020202020202020202020202020202020202020202020202020202020202020202020202020202020202020256563f56020202020202
03030303030330b73203030303030303030303030303030303030303030303030202020202020202020202020202020202020202020202020202020202020202020202020202020202020202020202020202020202020202020202020202020202020202020202020202020202020202020202020202560e4456020202020202
0303030303030303030303030303030303030303030303030303030303030303020202020202020202020202020202020202020202020202020202020202020202020202020202020202020202020202020202020202020202020202020202020202020202020202020202020202020202020202020256565656020202020202
0303030303030303030303030303030303030303030303030303030303030303020202020202020202020202020202020202020202020202020202020202020202020202020202020202020202020202020202020202020202020202020202020202020202020202020202020202020202020202020101010101010202020202
020202020256010e01560202020202020e015601020202020202020202020202020202020202020202020202020202020202020202020202020202020202020202020202020202020202020202020202020202020202020202020202020202020202020202020202020202020202020202020202020202020202020202020202
0202020201560144015601020202020244015601020202020202020202020202020202020202020202020202020202020202020202020202020202020202020202020202020202020202020202020202020202020202020202020202020202020202020202020202020202020202020202020202020202020202020202020202
02020202025656b5565602020202020208565601020202020202020202020202020202020202020202020202020202020202020202020202020202020202020202020202020202020202020202020202020202020202020202020202020202020202020202020202020202020202020202020202020202020202020202020202
020202020202563f5602020202020202b5013f01020202020202020202020202020202020202020202020202020202020202020202020202020202020202020202020202020202020202020202020202020202020202020202020202020202020202020202020202020202020202020202020202020202020202020202020202
02020202020202b5020202020202020256565601020202020202020202020202020202020202020202020202020202020202020202020202020202020202020202020202020202020202020202020202020202020202020202020202020202020102020202020202020202020202020202020202020202020202020202020202
0202020202020202020202020202020202020202020202020202020202020202020202020202020202020202020202020202020202020202020202020202020202020202020202020202020202020202020202020202020202020202020202020156565602020202020202020202020202020202020202020202020202020201
02020202020202020202020202020202020202020202020202020202020202020202020202020202020202020202020202020202020202020202020202020202020202020202020202020202020202020202020202020202020202020202020201560e5602020202020202020202020202020202020202020202025656565601
0202020202020202020202020202020202020202020202020202020202020202020202020202020202020202020202020202020202020202020202020202020202020202020202020202020202020202020202020202020202020202020202020156445602020202020202020202020202020202020202020201565601015601
02020202020202020202020202020202020202020202020202020202020202020202020202020202020202020202020202020202020202020202020202020202020202020202020202020202020202020202020202020202020202020202020201560856565601020202020202020202020202020202020202013f01080e5601
0202020202020202020202020202020202020202020202020202020202020202020202020202020202020202020202020202020202020202020202020202020202020202020202020202020202020202020202020202020202020202020256560156b501013f0102020202020202020202020202020202020201560108445601
02020202020202020202020202020202020202020202020202020202020202020202020202020202020202020202020256565601020202020202020202020202020202020202020101010202020202020202020202020202020202020202560e0156565656560102020202020202020202020202020202020201565601015601
020202020202020202020202020202020202020202020202020202020202020202020202020202020202020202020202010e560102020202020202020202020202020202020202563f56020202020202020202020202020202020202020256080102020202020202020202020202020202020202020202020202025656565601
0202020202020202020202020202020202020202020202020202020202020202020202020202020202020202010101014456560102020202020202020202020202020202020256560156560202020202020202020202020202020202020256440202020202020202020202020202020202020202020202020202020202020201
020202020202020202020202020202020202020202020202020202020202020202020202020202020202020256563f56085601010202020202020202020202020202020202565601b501565602020202020202020202020201010202020256080202020202020202020202020202020202020202020202020202020202020202
02020202020202020202020202020202020202020202020202020202020202020202020202020202020202025601b50108563f5602020202020202020202020202020202015601084408015601020202020202020202020201565656565656080202020202020202020202020202020202020202020202020202020202020202
020202020202020202020202020202020202020202020202020202020202020202020202020202020202020256080e44b501015602020202020202020202020202020202015656080e085656010202020202020202020202013f0101010101b50202020202020202020202020202020202020202020202020202020202020202
